R 1000 750
NO ./textures_xpm/wood.xpm
SO ./textures_xpm/redbrick.xpm
WE ./textures_xpm/eagle.xpm
ES ./textures_xpm/purplestone.xpm
S ./sprites/king_gun.xpm
F 200,201,202
C 101,101,101
1 1 1 1 1 1 1 1 1 1
1 0 2 0 1 0 0 0 0 1
1 0 0 0 1 0 0 0 0 1
1 0 0 0 0 0 0 0 0 1
1 0 0 0 0 0 0 0 0 1
1 0 2 0 0 0 0 0 0 1
1 0 0 1 1 1 0 0 0 1
1 0 0 0 0 0 0 2 0 1
1 0 0 N 0 0 2 2 0 1
1 0 0 0 0 0 0 0 0 1
1 1 1 1 1 0 0 0 0 1
1 1 1 1 1 0 0 0 0 1
1 1 0 0 0 0 0 0 0 1
1 1 1 1 1 0 0 0 0 1
1 0 0 0 0 0 1 0 0 1
1 0 0 0 0 0 0 0 0 1
1 0 0 0 0 0 0 0 0 1
1 0 0 0 0 0 0 0 0 1
1 0 0 0 0 0 1 0 0 1
1 0 0 0 0 0 0 0 0 1
1 0 0 0 0 0 0 0 0 1
1 0 0 0 0 0 0 0 0 1
1 0 1 1 1 1 1 0 0 1
1 1 1 1 1 1 1 0 0 1
1 1 1 0 0 1 1 0 0 1
1 1 1 0 0 1 1 0 0 1
1 0 0 0 0 0 0 0 0 1
1 0 0 0 0 0 0 0 0 1
1 0 0 0 0 0 0 0 0 1
1 0 0 0 0 0 0 0 0 1
1 0 0 0 0 0 0 0 0 1
1 0 0 0 0 0 0 0 0 1
1 1 1 1 1 1 1 1 1 1
end
