R 500 250
NO ./textures_xpm/wood.xpm
SO ./textures_xpm/redbrick.xpm
WE ./textures_xpm/eagle.xpm
ES ./textures_xpm/purplestone.xpm
S ./sprites/king_gun.xpm
F 0,0,255
C 255,0,0
1 1 1 1 1 1 1 1 1 1 1 1
1 1 1 1 1 1 1 1 1 1 1 1
1 1 0 0 0 1 0 1 0 0 1 1
1 1 0 0 0 1 0 0 0 0 1 1
1 1 0 0 0 0 0 0 0 0 1 1
1 1 0 0 0 0 0 0 0 0 1 1
1 1 0 0 0 0 W 0 0 0 1 1
1 1 0 0 0 0 0 0 0 0 1 1
1 1 0 0 0 0 0 0 0 0 1 1
1 1 1 1 1 1 1 1 1 1 1 1
1 1 1 1 1 1 1 1 1 1 1 1
end
